####################################### 
########################################
##                                    ##
##                                    ##
##                                    ##
##                                    ##
##                F                   ##
##                                    ##
##                                    ##
##                   #########        ##
##                   # ##    #        ##
##                   #                ##
## ########## ## ######### #############
## #        #  # #           #         #
## ########   ## #      #    #         #
##    I    ##  #####    ########## #####
## # ##### #  ##   #         #         #
## # #         #   ####### ###         #
################   #                   #
########################################